1111111111111
1001CCC000EC1
1000011111111
1P001100000C1
1111111111111