1111111111111
1001CCC0000C1
1000011111111
1P001100000E1
1111111111111