11111111111111
1CC1CCCCCC0C11
11CCC111110111
1PCC11ECCC0C11
11C00000000CC1
1CCCCCCCCCCCC1
11111111111111