11111111111111
10010000000011
11000111110111
1P0011E0000011
11000000000001
10000000C00001
11111111111111